BB.............
BBBRRRR..G.....
....RRRGGGGCC..
..MMRR...G..C..
.MM..YYYYYCCC..
......YYY......
