RR......RRRRR
RRR..R....RRR
....RRR...RRR
R...RRRRR...R
RRRRR...RR...
RRR.........R
R.........RRR

